liam	olivia
noah	emma
oliver	ava
william	sophia
elijah	isabella
james	charlotte
benjamin	amelia
lucas	mia
mason	harper
alexander	abigail
henry	emily
jacob	ella
michael	elizabeth
daniel	camila
logan	luna
jackson	sofia
sebastian	avery
jack	mila
aiden	aria
owen	scarlett
samuel	penelope
matthew	layla
joseph	chloe
levi	victoria
mateo	madison
david	eleanor
john	grace
wyatt	nora
carter	riley
julian	zoey
luke	hannah
grayson	hazel
isaac	lily
jayden	ellie
gabriel	lillian
anthony	zoe
dylan	stella
leo	aurora
lincoln	natalie
jaxon	emilia
asher	everly
christopher	leah
josiah	aubrey
andrew	willow
thomas	addison
joshua	lucy
ezra	audrey
hudson	bella
charles	nova
isaiah	paisley
nathan	claire
adrian	skylar
christian	isla
maverick	genesis
colton	naomi
elias	elena
aaron	caroline
eli	eliana
landon	anna
nolan	valentina
cameron	kennedy
connor	ivy
jeremiah	aaliyah
ezekiel	cora
easton	kinsley
miles	hailey
robert	gabriella
jameson	allison
nicholas	gianna
greyson	serenity
cooper	samantha
ian	sarah
axel	quinn
jaxson	eva
dominic	piper
leonardo	sophie
luca	sadie
jordan	josephine
adam	nevaeh
xavier	adeline
jose	arya
jace	emery
everett	lydia
declan	clara
evan	vivian
kayden	madeline
parker	peyton
wesley	julia
kai	rylee
ryan	serena
jonathan	mandy
ronald	alice)